AROUND	ER AW N D
AROUND(2)	ER AW N
AT	AE T
BACKWARD	B AE K W ER D
BOLL	B OW L
CHASING	CH EY S IH NG
CLEAN	K L IY N
DANCE	D AE N S
DESK	D EH S K
FACE	F EY S
FORWARD	F AO R W ER D
GO	G OW
LEFT	L EH F T
LOOK	L UH K
ME	M IY
MY	M AY
PLAY	P L EY
RIGHT	R AY T
SAY	S EY
SOMEHING	S AA M AH AH NG
START	S T AA R T
THE	DH AH
THE(2)	DH IY
TRACK	T R AE K
TURN	T ER N
WITH	W IH DH
WITH(2)	W IH TH
YOURSELF	Y ER S EH L F
YOURSELF(2)	Y UH R S EH L F
YOURSELF(3)	Y AO R S EH L F
